XXXXXXXXXXXXXXXXXXXXXXXXXXXXXXXXXXXXXXXXXXXXXXXXXXXXXXXXXXXXXXXXXXXXXXXXXXXXXXXXXXXXXXXXXXXXXXXXXXXXXXXXXXXXXXXXXXXXXXXXXXXXXXXXXXXXXXXXXXXXXXXXXXXXXXXX
X                                          X                                 X                       X                   X       X       X             X
X                                          X                                 X                       X                   X       X       X             X
X                                          X   G                             X                       X                   X       X       X             X
X                                          X                                 X                       X                   X       X       X             X
X                                          X                                 X                       X                   X       X       X             X
X               XXXXXXXXXXXXXXXX           X                                 X                       X                   X       X       X             X
X               X              X           X                                 X                       X                   X       X       X             X
X   XXXXXXXXXXXXX              XXXXXXXXXXXXX                                 X                       X                   X       X       X             X
X   X                                    X XXXXXXX  XXXXXXXXXXXXXX  XXXXXXXXXXXXXXX  XXXXXXXXXXXXXX  XXX  XXXXXXXXXXXXX  XXX  XXXXXXXXXXXX             X
XXXXX                                    XXXXXXXXX    XXXXXXXXXX    XXXXXXXXXXXXXXX    XXXXXXXXXX    XXX    XXXXXXXXX    XXX    XXXXXXXXXX             X
X                                                                                                                                        X             X
X                                                                                                                                        X             X
XXXXX                 XX                 XXXXXXXXXXXXXXXXXXXXXXXXXXXXXXXXXXXXXX    XXXXXXXXXXX    XXXXXXXXXXXXXXXXXXXXXXXXXXXXXXXXXXX    X             X
X   X                 XX                 X                                    X    X         XX       X                             X    X             X
X   X                                    X                                    X    X         X        X                             X    X             X
X   X          XX             XX         X       XXXXXXXXXXXXXXXXXXXXXXXXXXXXXXX  XX        X         X                             X    X             X
X   X          XX             XX         X       X                                X         X         X                             X    X             X
X   X                                    X       X                                X         X         X                             X    X             X
X   X                                   XX       X                                X         X         X                             X    X             X
X   X                                  XXX       X                                X         X         X                             X    X             X
X   X                                   XXXXXXXXXX                                X         X         X                             X    X             X
X   X          XX             XX         X                                        X         X         X                             X    XXXXXXXXXXXXXXX
X   X          XX             XX                                                  X         X         X                             X    X             X
X   X                                                                             X          X        X                             X    X             X
X   X              XXXXXXX               XXXXXXXXX                                X           X       X                             X                  X
X   X               XXXXX                X       X                                X          X        X                             X    X             X
X   X                 X                  XXXXXXXXXXXXXXXXXXXXXXXXXXXXXXXXXXXXXX  XXXXXXXXXXXX   XXXXXXXXXXXXXXXXXXXXXXXXXXXXXXXXXXXXX    X             X
X   X                                                                                                                                    X             X
X   X                                                                                                                                    X             X
X   X          XX  X    X     XX         XXXXXXXXXXXX   XXXXXXXXXXXXXXXXXXXXXXXXXXX   XXXXXXXXXXXXXXXXXXXX   XXXXXXXXXXXXXXXXX   XXXX    X             X
X   X          XX             XX         X          X  XXXXXXXXXXXXXXXXXXXXXXXXXXXX  XXXXXXXXXXXXXXXXXXXXX  XXXXXXXXXXXXXXXXXX  XXXXX    X             X
X   X                                    X          X             X                                                                 X    XXXXXXXXXXXXXXX
X   X                                    X          X             X                  X                      X                       X    X             X
X   X                                    X          X             X                  X                      X                       X    X             X
X   X                                    X          X             X                  X                      X                       X    X             X
X   X                                    X          X             X                  X                      X                       X    X             X
X   X                                    X          X             X                  X                      X                       X    X             X
XXXXX                                    X          X             X                  X                      X                       X                  X
X                                        X          X             X                  X                      X                       XX   XXXXXXXXXXXXXXX
X               X             X          XXXXXXXXXXXXXXXXXXXXXXXXXXXXXXXXXXXXXXXXXXXXXXXXXXXXXXXXXXXXXXXXXXXXXXXXXXXXXXXXXXXXXXXXXXXXX   X             X
XXXXX                                    XXXXXXXXXXXXXXXXXXXXXXXXXXXXXXXXXXXXXXXXXXXXXXXXXXXXXXXXXXXXXXXXXXXXXXXXXXXXXXXXXXXXXXXXXXXXX  XXX            X
X   X                                     X                                                                               X                X           X
X   X                                     X                                                                               X                X           X
XXXXX                                     XXXXXXXXXXXXXXXXXXXXXXXXXXXXXXXXXXXXXXXXXXXXXXXXXXXXXXXXXXXXXXXXXXXXXXXXXXXXXXXXX                X           X
X                                                                                                                                          X           X
X                                                                                                                                          X           X
XXXXXXXXXXXXXXXXXXXXX     XXXXXXXXXXXXXXXXX       XXXXXXXXXXX       XXXXXXXXXXX       XXXXXXXXXXX       XXXXXXXXXXX       XXXXXXXXXXX      X           X
X                   XXXXXXX   X              XXX  X    X    X  XXX  X    X    X  XXX  X    X    X  XXX  X    X    X  XXX  X    X    X  XX  XXXXXXX     X
X                             X               X        X       X         X        X        X        X        X        X        X        X         X    X
X                             X               X        X       X         X        X        X        X        X        X        X        X         X    X
X                             X               X        X       X         X        X        X        X        X   S    X        X        X         X    X
X                             X               X        X       X         X        X        X        X        X        X        X        X         X    X
X                             X               X        X       X         X        X        X        X        X        X        X        X         X    X
X                             X               X        X       X         X        X        X        X        X        X        X        X         X    X
X                             X               X        X       X         X        X        X        X        X        X        X        X         X    X
XXXXXXXXXXXXXXXXXXXXXXXXXXXXXXXXXXXXXXXXXXXXXXXXXXXXXXXXXXXXXXXXXXXXXXXXXXXXXXXXXXXXXXXXXXXXXXXXXXXXXXXXXXXXXXXXXXXXXXXXXXXXXXXXXXXXXXXXXXXXXXXXXXXXXXXX
