XXXXXXX
XG    X
XXX   X
X   X X
X   X X
X X  SX
XXXXXXX