XXXXXXX
X    GX
X   XXX
X X   X
X X   X
XS  X X
XXXXXXX