XXXXXXXXXXXXXXXXXXXXXXXXXXXXXXXXXXXXXXXXXXXXXXXXXXXXXXXXXXXXXXXXXXXXXXXXXXXXX
XS XX  XXXXX              XXXXXXXX         XXXX                             X
X   X                     X      X         XXXXXX XXXXXXXXXXXX              X
X   X  X X X        XXXXXXX  XX  XXXXXXXX         XXXX                      X
X   X   X X               X      X         XXXXXXXXXXXXXXXXXXX              X
X  XX  X X X X X X X X X   X X X   X X X   X X X X X X X X X X X X X X X XGXX
X X X X X X X X X X X X     X X    X X X  X  X X  X X   X  X X  X    X   X  X
X   X   X X               X      X         XXXXXXXXXXXXXXXXXXX              X
X   X  X X X        XXXXXXX  XX  XXXXXXXX         XXXX                      X
X       X X               X      X         XXXXXXXXXXXXXXXXXXX              X
X  XX  XXXXX              XXXXXXXX                        XXXX              X
XXXXXXXXXXXXXXXXXXXXXXXXXXXXXXXXXXXXXXXXXXXXXXXXXXXXXXXXXXXXXXXXXXXXXXXXXXXXX

