XXXXXXX
X    SX
X   XXX
X X   X
X X   X
XG  X X
XXXXXXX